Amount,Sender_Old_Balance,Transaction_Time,Geo_Location_Mismatched,Transaction_Frequency,Same_Bank,Transaction_Type,Sender_New_Balance,Receiver_Old_Balance,Receiver_New_Balance,Receiver_New_Balance_Wrong,Suspicious_Label
7949,44224,23,No,2,No,POS,36275,35836,43785,No,Suspicious-Needs Monitoring
7370,32632,9,Yes,7,No,ATM,25262,47112,54482,No,Highly Suspicious
960,46563,23,No,3,No,Online,45603,20958,21918,Yes,Highly Suspicious
5490,49409,3,Yes,9,No,Wire,43919,28369,33859,No,Highly Suspicious
5291,25530,19,No,6,Yes,POS,20239,16689,21980,No,No Suspicious
5834,44964,3,No,9,No,Wire,39130,22331,28165,No,Highly Suspicious
6365,49327,21,No,5,Yes,ATM,42962,42528,48893,No,No Suspicious
566,8368,6,Yes,7,Yes,Online,7802,18436,19002,No,Suspicious-Needs Monitoring
4526,8797,21,No,4,No,Online,4271,5066,9592,No,No Suspicious
5678,18718,0,No,7,Yes,POS,13040,35725,41403,Yes,Highly Suspicious
8422,39560,11,No,1,Yes,Online,31138,30212,38634,No,No Suspicious
1785,16053,23,No,7,Yes,Online,14268,38332,40117,No,Suspicious-Needs Monitoring
869,27116,12,Yes,8,Yes,Wire,26247,30401,31270,No,Suspicious-Needs Monitoring
7049,41244,9,No,5,Yes,Online,34195,18393,25442,No,No Suspicious
2533,41185,14,Yes,2,No,Online,38652,8670,11203,No,Suspicious-Needs Monitoring
5411,6645,12,No,5,No,Online,1234,30601,36012,No,No Suspicious
5151,24256,22,No,6,Yes,POS,19105,7251,12402,No,No Suspicious
6520,40840,21,Yes,2,Yes,POS,34320,38572,45092,Yes,Highly Suspicious
1284,39622,21,Yes,6,Yes,Wire,38338,32027,33311,No,Suspicious-Needs Monitoring
4655,42430,20,Yes,6,No,Online,37775,36846,41501,No,Highly Suspicious
3485,44282,21,No,1,Yes,POS,40797,26015,29500,No,No Suspicious
6496,7708,8,No,1,Yes,POS,1212,14583,21079,No,No Suspicious
8766,16694,8,No,3,Yes,Wire,7928,28104,36870,No,No Suspicious
9374,14524,14,Yes,3,Yes,ATM,5150,17224,26598,No,No Suspicious
2658,36880,9,Yes,4,Yes,Online,34222,43784,46442,No,No Suspicious
7949,44224,23,No,2,No,POS,36275,35836,43785,No,Suspicious-Needs Monitoring
2147,41980,9,Yes,9,Yes,Wire,39833,34299,36446,No,Suspicious-Needs Monitoring
2847,37409,7,No,7,Yes,Wire,34562,18036,20883,No,No Suspicious
9267,18224,23,No,7,Yes,Wire,8957,24933,34200,No,Suspicious-Needs Monitoring
289,45738,15,No,6,No,POS,45449,17392,17681,No,Suspicious-Needs Monitoring
2834,30150,16,No,3,Yes,Online,27316,12938,15772,No,No Suspicious
3105,39393,4,No,6,Yes,ATM,36288,9141,12246,Yes,Highly Suspicious
4758,48082,3,Yes,8,Yes,Online,43324,28350,33108,No,Highly Suspicious
1999,12973,17,Yes,8,Yes,Wire,10974,14546,16545,No,Suspicious-Needs Monitoring
7834,13577,23,Yes,9,No,Wire,5743,10335,18169,No,Highly Suspicious
1367,13070,18,No,1,Yes,ATM,11703,10077,11444,No,No Suspicious
1628,13666,3,Yes,1,No,Online,12038,10611,12239,No,Highly Suspicious
3656,41368,6,No,3,Yes,Wire,37712,45857,49513,Yes,Highly Suspicious
3990,11783,9,No,3,No,Wire,7793,40660,44650,No,No Suspicious
8938,46914,17,No,8,Yes,Online,37976,10577,19515,No,No Suspicious
5493,9971,18,No,1,No,Wire,4478,25002,30495,No,No Suspicious
8892,18490,3,Yes,2,Yes,Online,9598,44451,53343,No,Suspicious-Needs Monitoring
8533,6990,9,No,2,Yes,Wire,-1543,39275,47808,No,No Suspicious
7613,10299,0,No,3,No,Online,2686,33647,41260,No,Suspicious-Needs Monitoring
2712,24956,22,Yes,6,Yes,ATM,22244,39831,42543,No,Suspicious-Needs Monitoring
7141,27359,17,Yes,1,Yes,Wire,20218,39768,46909,No,No Suspicious
9655,42148,4,No,2,Yes,ATM,32493,35962,45617,No,No Suspicious
6335,33734,14,No,1,Yes,Wire,27399,34583,40918,No,No Suspicious
5586,9757,16,No,5,Yes,Wire,4171,6294,11880,No,No Suspicious
7199,24097,2,No,7,Yes,POS,16898,20096,27295,Yes,Highly Suspicious
9770,15395,11,No,8,Yes,Online,5625,41833,51603,No,No Suspicious
875,21241,1,No,1,No,ATM,20366,32328,33203,No,Suspicious-Needs Monitoring
8326,43356,0,No,7,Yes,ATM,35030,29398,37724,No,Suspicious-Needs Monitoring
3252,32696,22,No,5,No,ATM,29444,22706,25958,No,No Suspicious
1685,9944,20,No,1,No,Online,8259,27340,29025,No,No Suspicious
4043,24816,16,No,3,Yes,POS,20773,23825,27868,No,No Suspicious
7655,42011,21,No,7,Yes,ATM,34356,22482,30137,No,No Suspicious
3173,29917,15,No,1,Yes,Online,26744,14318,17491,No,No Suspicious
1121,36195,4,No,7,Yes,Wire,35074,46256,47377,No,Suspicious-Needs Monitoring
3943,26566,14,No,5,No,ATM,22623,49009,52952,No,No Suspicious
8089,14916,2,No,1,Yes,ATM,6827,48185,56274,No,No Suspicious
9792,25806,6,No,1,Yes,POS,16014,20574,30366,No,No Suspicious
6973,14984,10,No,1,Yes,ATM,8011,19650,26623,No,No Suspicious
5775,6759,9,Yes,9,Yes,ATM,984,33930,39705,No,Suspicious-Needs Monitoring
261,46949,8,No,3,Yes,Wire,46688,25171,25432,No,No Suspicious
4397,31838,13,Yes,5,Yes,Online,27441,39864,44261,No,No Suspicious
1095,7482,12,No,9,No,Online,6387,16801,17896,No,Suspicious-Needs Monitoring
7729,29442,1,No,6,Yes,POS,21713,27372,35101,No,Suspicious-Needs Monitoring
9567,38719,2,No,9,Yes,Wire,29152,21559,31126,Yes,Highly Suspicious
1116,32965,6,No,8,No,Online,31849,37334,38450,No,Suspicious-Needs Monitoring
7969,7079,20,No,8,Yes,Wire,-890,44937,52906,Yes,Highly Suspicious
6539,7717,17,No,1,No,Online,1178,18288,24827,No,No Suspicious
7992,32952,2,No,9,No,Wire,24960,27398,35390,No,Highly Suspicious
6963,25908,9,No,6,No,POS,18945,15694,22657,No,Suspicious-Needs Monitoring
8016,47460,21,Yes,9,No,ATM,39444,17191,25207,No,Highly Suspicious
8629,29861,6,Yes,3,Yes,POS,21232,23051,31680,Yes,Highly Suspicious
978,12311,8,No,3,No,Online,11333,15737,16715,No,No Suspicious
9368,33071,16,No,6,Yes,POS,23703,30251,39619,No,No Suspicious
4987,28570,10,Yes,9,No,ATM,23583,10147,15134,No,Highly Suspicious
4959,23449,6,Yes,7,No,POS,18490,24643,29602,No,Highly Suspicious
6431,38536,23,Yes,3,No,Online,32105,43967,50398,No,Highly Suspicious
8671,43258,13,No,3,No,Online,34587,38314,46985,No,No Suspicious
8784,33865,18,No,2,Yes,POS,25081,42999,51783,No,No Suspicious
7308,11645,3,No,9,No,ATM,4337,45733,53041,No,Highly Suspicious
5376,43000,5,Yes,3,Yes,POS,37624,23467,28843,No,No Suspicious
2162,31737,9,No,5,No,ATM,29575,39808,41970,Yes,Highly Suspicious
164,16485,6,Yes,9,Yes,Wire,16321,6752,6916,No,Suspicious-Needs Monitoring
8106,43565,12,Yes,8,Yes,ATM,35459,6849,14955,No,Suspicious-Needs Monitoring
2668,30522,13,No,2,Yes,Wire,27854,7642,10310,No,No Suspicious
5563,17342,3,Yes,3,Yes,POS,11779,6600,12163,No,Suspicious-Needs Monitoring
2127,45806,7,Yes,2,No,ATM,43679,25786,27913,No,Suspicious-Needs Monitoring
2795,18087,4,Yes,8,Yes,Wire,15292,49565,52360,No,Highly Suspicious
9787,42641,0,Yes,6,Yes,Wire,32854,25183,34970,Yes,Highly Suspicious
5358,39249,3,Yes,6,Yes,Wire,33891,6132,11490,No,Highly Suspicious
5718,15093,2,No,9,No,Online,9375,43259,48977,Yes,Highly Suspicious
6836,21438,8,No,8,Yes,POS,14602,36076,42912,No,No Suspicious
491,45411,7,No,4,Yes,Wire,44920,43563,44054,No,No Suspicious
5992,31399,0,No,4,Yes,ATM,25407,31691,37683,No,No Suspicious
3661,24846,5,Yes,9,Yes,Wire,21185,48299,51960,No,Suspicious-Needs Monitoring
6284,20708,8,No,1,Yes,Online,14424,15931,22215,No,No Suspicious
3199,49039,6,No,2,Yes,POS,45840,12633,15832,No,No Suspicious
6378,15998,3,Yes,2,Yes,Online,9620,42777,49155,No,Suspicious-Needs Monitoring
8492,35678,12,No,6,No,Online,27186,39881,48373,No,Suspicious-Needs Monitoring
3204,15682,16,Yes,4,No,Online,12478,6044,9248,No,Suspicious-Needs Monitoring
7315,13519,1,No,3,Yes,ATM,6204,40199,47514,No,No Suspicious
2554,36480,4,No,3,No,POS,33926,29363,31917,No,Suspicious-Needs Monitoring
9096,24694,11,No,3,Yes,POS,15598,6582,15678,No,No Suspicious
2831,8300,20,No,6,Yes,ATM,5469,19374,22205,No,No Suspicious
8254,11722,7,No,8,Yes,POS,3468,6308,14562,No,No Suspicious
9862,44986,5,No,7,Yes,Online,35124,26301,36163,No,No Suspicious
5156,29160,7,Yes,4,Yes,POS,24004,13793,18949,Yes,Highly Suspicious
8210,25059,17,Yes,4,Yes,ATM,16849,6620,14830,No,No Suspicious
3940,40822,2,No,2,Yes,Online,36882,34883,38823,No,No Suspicious
1128,18575,21,No,1,No,ATM,17447,42534,43662,No,No Suspicious
7485,12970,11,No,9,Yes,Wire,5485,42960,50445,No,No Suspicious
602,39911,2,No,2,Yes,Online,39309,44390,44992,No,No Suspicious
7010,26591,21,No,8,Yes,Online,19581,11093,18103,No,No Suspicious
9162,36821,5,No,9,Yes,POS,27659,27259,36421,No,No Suspicious
7038,14503,1,No,4,Yes,Online,7465,25655,32693,No,No Suspicious
4588,23922,22,No,8,Yes,ATM,19334,38005,42593,No,No Suspicious
306,17175,11,No,9,No,POS,16869,36629,36935,No,Suspicious-Needs Monitoring
5234,46124,1,No,5,Yes,Wire,40890,28610,33844,No,No Suspicious
6077,26389,5,Yes,7,Yes,ATM,20312,26602,32679,No,Suspicious-Needs Monitoring
7821,5822,16,No,4,Yes,Wire,-1999,25409,33230,No,No Suspicious
7135,22327,2,Yes,1,Yes,Wire,15192,16110,23245,Yes,Highly Suspicious
1584,11150,1,Yes,3,Yes,Wire,9566,11073,12657,No,Suspicious-Needs Monitoring
7958,9425,22,Yes,5,Yes,Online,1467,40310,48268,No,No Suspicious
963,21032,19,No,3,Yes,ATM,20069,20282,21245,No,No Suspicious
2890,7198,7,No,7,Yes,ATM,4308,15195,18085,Yes,Highly Suspicious
7508,25079,21,Yes,9,Yes,Online,17571,6537,14045,No,Suspicious-Needs Monitoring
8855,41220,11,No,6,Yes,POS,32365,22138,30993,Yes,Highly Suspicious
5216,46874,3,No,1,Yes,Wire,41658,49328,54544,Yes,Highly Suspicious
6119,18859,4,No,7,Yes,ATM,12740,45164,51283,No,Suspicious-Needs Monitoring
1857,36419,12,Yes,3,Yes,Online,34562,29207,31064,No,No Suspicious
7674,13705,14,No,5,Yes,Wire,6031,25619,33293,No,No Suspicious
6474,47880,22,No,4,Yes,POS,41406,29845,36319,No,No Suspicious
6992,28236,15,Yes,5,Yes,POS,21244,29310,36302,No,No Suspicious
1778,27419,9,Yes,5,Yes,Wire,25641,42899,44677,Yes,Highly Suspicious
3342,24978,22,No,6,Yes,POS,21636,35562,38904,No,No Suspicious
4736,42609,15,No,6,No,ATM,37873,33036,37772,No,Suspicious-Needs Monitoring
1159,20358,11,No,8,Yes,ATM,19199,13697,14856,No,No Suspicious
6768,39177,16,No,8,No,ATM,32409,22513,29281,No,Suspicious-Needs Monitoring
3257,34378,15,No,9,Yes,POS,31121,48039,51296,No,No Suspicious
6015,42334,11,No,8,Yes,ATM,36319,8145,14160,No,No Suspicious
9889,16382,7,Yes,2,Yes,Online,6493,32818,42707,No,No Suspicious
2793,19596,19,No,1,Yes,ATM,16803,35544,38337,No,No Suspicious
3727,38572,2,No,2,Yes,ATM,34845,18100,21827,No,No Suspicious
9655,18221,15,No,2,Yes,POS,8566,25104,34759,No,No Suspicious
5550,6279,12,No,3,Yes,ATM,729,9067,14617,No,No Suspicious
1763,12083,22,No,7,Yes,Wire,10320,41963,43726,No,No Suspicious
9821,48861,18,Yes,2,No,Online,39040,35728,45549,No,Suspicious-Needs Monitoring
5692,22771,7,No,1,No,POS,17079,37317,43009,Yes,Highly Suspicious
7492,34975,21,Yes,6,Yes,Online,27483,36416,43908,No,Suspicious-Needs Monitoring
1406,24063,4,No,9,Yes,Wire,22657,47012,48418,Yes,Highly Suspicious
6876,7106,19,Yes,3,Yes,POS,230,45049,51925,No,No Suspicious
5964,29557,7,Yes,6,Yes,POS,23593,7509,13473,No,Suspicious-Needs Monitoring
9574,25607,23,No,3,Yes,ATM,16033,26400,35974,No,No Suspicious
7626,42599,11,Yes,1,No,Online,34973,11533,19159,No,Suspicious-Needs Monitoring
9001,33529,0,No,5,Yes,Wire,24528,19670,28671,No,No Suspicious
5675,40954,20,No,4,Yes,Wire,35279,8932,14607,No,No Suspicious
5630,32856,19,Yes,7,Yes,POS,27226,43328,48958,Yes,Highly Suspicious
4513,7573,5,Yes,6,No,ATM,3060,41784,46297,Yes,Highly Suspicious
3848,17808,21,No,7,Yes,POS,13960,28723,32571,No,No Suspicious
763,40367,17,No,5,Yes,POS,39604,5719,6482,No,No Suspicious
2098,41801,7,No,4,No,POS,39703,5074,7172,No,No Suspicious
8094,46196,6,No,7,Yes,POS,38102,31498,39592,No,No Suspicious
1595,39072,0,No,7,No,Wire,37477,36345,37940,No,Highly Suspicious
3404,28752,20,No,6,Yes,Wire,25348,25541,28945,No,No Suspicious
3863,22685,15,No,8,No,POS,18822,39917,43780,No,Suspicious-Needs Monitoring
5332,46401,11,No,4,Yes,POS,41069,31028,36360,No,No Suspicious
1953,16372,5,Yes,5,Yes,ATM,14419,34545,36498,No,No Suspicious
6685,13996,19,No,4,No,POS,7311,19033,25718,No,No Suspicious
1391,21458,1,No,1,Yes,Wire,20067,36673,38064,Yes,Highly Suspicious
3681,36889,13,No,8,Yes,Online,33208,35974,39655,No,No Suspicious
7654,31665,3,No,1,Yes,Wire,24011,28097,35751,No,No Suspicious
7380,43243,0,No,5,Yes,ATM,35863,41975,49355,No,No Suspicious
1736,36653,22,No,6,Yes,Wire,34917,32608,34344,No,No Suspicious
3796,31657,17,No,6,Yes,Online,27861,28525,32321,No,No Suspicious
798,44952,12,No,5,Yes,POS,44154,20043,20841,No,No Suspicious
4837,27180,1,No,3,Yes,Online,22343,46846,51683,No,No Suspicious
954,36896,8,No,5,Yes,POS,35942,16725,17679,Yes,Highly Suspicious
8264,17875,20,No,8,Yes,POS,9611,41704,49968,No,No Suspicious
5955,6622,1,No,2,No,Wire,667,47075,53030,No,Suspicious-Needs Monitoring
7492,45809,8,No,6,No,Wire,38317,42383,49875,No,Suspicious-Needs Monitoring
6628,21725,0,No,9,No,Wire,15097,34483,41111,Yes,Highly Suspicious
5349,45760,10,No,8,Yes,ATM,40411,12265,17614,No,No Suspicious
5272,20646,2,Yes,8,Yes,Wire,15374,27763,33035,No,Highly Suspicious
1807,22029,19,No,8,Yes,ATM,20222,15116,16923,No,No Suspicious
5891,34402,22,Yes,7,Yes,Wire,28511,20733,26624,No,Suspicious-Needs Monitoring
5635,9263,3,No,8,Yes,POS,3628,30502,36137,No,Suspicious-Needs Monitoring
5031,35987,17,No,6,Yes,ATM,30956,42420,47451,No,No Suspicious
3610,13646,22,Yes,2,Yes,Online,10036,48241,51851,No,No Suspicious
302,32529,5,Yes,2,No,ATM,32227,14247,14549,No,Suspicious-Needs Monitoring
4318,16664,2,No,8,Yes,ATM,12346,28840,33158,No,Suspicious-Needs Monitoring
9058,40737,21,No,1,Yes,Online,31679,26058,35116,No,No Suspicious
4489,40796,10,No,6,Yes,ATM,36307,39929,44418,No,No Suspicious
2427,29027,14,Yes,6,Yes,POS,26600,23635,26062,No,Suspicious-Needs Monitoring
8104,34373,21,No,4,No,Wire,26269,30628,38732,No,No Suspicious
3031,41397,4,No,3,Yes,Online,38366,36362,39393,Yes,Highly Suspicious
7877,25609,19,No,3,Yes,Wire,17732,25953,33830,Yes,Highly Suspicious
297,40835,9,No,1,Yes,POS,40538,24128,24425,No,No Suspicious
7225,43709,11,No,3,Yes,Online,36484,17061,24286,Yes,Highly Suspicious
2030,24250,14,Yes,4,Yes,Wire,22220,11041,13071,No,No Suspicious
6387,26172,16,No,5,No,Wire,19785,17673,24060,No,No Suspicious
8900,16555,9,No,3,No,POS,7655,26059,34959,No,No Suspicious
9439,26874,5,No,6,No,Wire,17435,39328,48767,No,Suspicious-Needs Monitoring
4382,18081,17,Yes,5,Yes,POS,13699,49722,54104,No,No Suspicious
2611,29063,12,No,3,No,ATM,26452,22548,25159,No,No Suspicious
759,11819,2,Yes,6,Yes,POS,11060,20078,20837,No,Highly Suspicious
2911,30712,23,No,6,Yes,ATM,27801,10419,13330,No,Suspicious-Needs Monitoring
7198,29762,9,No,8,Yes,Online,22564,40490,47688,Yes,Highly Suspicious
6646,16046,13,No,2,Yes,Wire,9400,15550,22196,No,No Suspicious
9661,36463,5,Yes,1,Yes,POS,26802,35337,44998,No,No Suspicious
2086,33769,2,Yes,4,No,POS,31683,6468,8554,No,Highly Suspicious
8438,28150,15,No,7,Yes,Wire,19712,29309,37747,Yes,Highly Suspicious
3011,7711,6,Yes,3,Yes,Wire,4700,5808,8819,No,No Suspicious
1834,9853,19,Yes,3,Yes,Online,8019,29747,31581,No,No Suspicious
1943,34077,13,No,5,No,Online,32134,11719,13662,No,No Suspicious
8780,28863,8,No,5,No,POS,20083,21363,30143,No,No Suspicious
3076,26792,14,Yes,3,No,Online,23716,33718,36794,No,Suspicious-Needs Monitoring
2059,45483,20,No,9,Yes,ATM,43424,33801,35860,No,No Suspicious
5859,13942,2,Yes,4,Yes,Online,8083,48359,54218,No,Suspicious-Needs Monitoring
6794,6762,1,No,3,Yes,Online,-32,42841,49635,No,No Suspicious
2485,36987,1,No,2,Yes,POS,34502,13012,15497,No,No Suspicious
4836,20850,2,No,9,Yes,ATM,16014,23029,27865,No,Suspicious-Needs Monitoring
1902,17112,17,No,4,Yes,Online,15210,46017,47919,No,No Suspicious
8255,29058,13,No,3,Yes,ATM,20803,5767,14022,No,No Suspicious
8220,43890,19,No,7,No,ATM,35670,8895,17115,No,Suspicious-Needs Monitoring
6716,5481,17,Yes,8,Yes,ATM,-1235,47968,54684,No,Suspicious-Needs Monitoring
5634,37921,9,No,2,Yes,Wire,32287,45097,50731,No,No Suspicious
4161,45385,1,No,7,Yes,Wire,41224,20332,24493,No,Suspicious-Needs Monitoring
362,6524,21,No,5,No,Wire,6162,19621,19983,No,No Suspicious
6387,39888,0,No,5,No,Wire,33501,16334,22721,No,Suspicious-Needs Monitoring
8915,20048,3,No,3,No,POS,11133,23174,32089,No,Suspicious-Needs Monitoring
9308,40111,13,Yes,5,No,Online,30803,38653,47961,No,Suspicious-Needs Monitoring
2149,42904,0,No,2,Yes,Wire,40755,45502,47651,No,No Suspicious
5523,39008,13,No,4,Yes,POS,33485,41674,47197,No,No Suspicious
4648,5060,15,No,6,Yes,Online,412,42260,46908,No,No Suspicious
3208,14130,21,No,1,Yes,Wire,10922,47498,50706,No,No Suspicious
7258,23023,13,No,4,Yes,Online,15765,7073,14331,No,No Suspicious
7500,18350,19,No,6,Yes,Wire,10850,11269,18769,Yes,Highly Suspicious
3270,29354,2,Yes,9,No,POS,26084,22194,25464,No,Highly Suspicious
9974,33145,2,Yes,2,No,ATM,23171,31811,41785,No,Highly Suspicious
2355,39020,8,Yes,7,No,ATM,36665,11841,14196,No,Highly Suspicious
1254,25587,5,No,6,No,Online,24333,48723,49977,No,Suspicious-Needs Monitoring
4599,46131,12,Yes,2,Yes,POS,41532,39800,44399,No,No Suspicious
6395,14650,20,No,8,Yes,ATM,8255,14699,21094,No,No Suspicious
6297,24933,1,No,7,Yes,Wire,18636,15762,22059,No,Suspicious-Needs Monitoring
9988,25581,7,No,5,Yes,ATM,15593,44897,54885,No,No Suspicious
1748,28393,20,No,5,No,Online,26645,46556,48304,No,No Suspicious
5639,28051,1,Yes,7,Yes,Online,22412,7147,12786,No,Highly Suspicious
9737,31212,3,No,9,No,POS,21475,38383,48120,No,Highly Suspicious
4299,9090,14,No,9,Yes,Online,4791,38715,43014,No,No Suspicious
8545,11960,3,No,9,Yes,ATM,3415,43445,51990,No,Suspicious-Needs Monitoring
2657,40772,12,No,6,Yes,ATM,38115,45634,48291,No,No Suspicious
5692,26520,11,No,6,Yes,ATM,20828,7013,12705,No,No Suspicious
198,41408,12,No,3,Yes,ATM,41210,25081,25279,No,No Suspicious
2300,33470,13,No,1,Yes,POS,31170,21874,24174,No,No Suspicious
3061,25491,19,No,7,No,Wire,22430,42755,45816,No,Suspicious-Needs Monitoring
5073,6341,17,No,4,Yes,Wire,1268,13733,18806,No,No Suspicious
4533,49623,5,Yes,1,Yes,POS,45090,14479,19012,No,No Suspicious
2969,29791,10,No,8,Yes,Online,26822,14825,17794,No,No Suspicious
1056,5338,1,Yes,6,Yes,Wire,4282,26304,27360,No,Highly Suspicious
8452,10895,22,No,6,No,Online,2443,40694,49146,No,Suspicious-Needs Monitoring
5799,17254,18,No,2,Yes,Wire,11455,45050,50849,No,No Suspicious
7044,16344,18,Yes,1,No,Online,9300,20635,27679,Yes,Highly Suspicious
4593,6750,4,No,2,Yes,POS,2157,25760,30353,No,No Suspicious
9592,7421,18,No,4,No,ATM,-2171,14490,24082,No,No Suspicious
5011,44887,1,No,2,Yes,Online,39876,26252,31263,No,No Suspicious
4087,10319,9,No,1,Yes,ATM,6232,44754,48841,No,No Suspicious
9819,20896,1,No,7,Yes,Online,11077,11862,21681,No,Suspicious-Needs Monitoring
6115,16918,10,Yes,8,Yes,Online,10803,49927,56042,No,Suspicious-Needs Monitoring
1318,30064,17,No,6,Yes,Online,28746,9423,10741,No,No Suspicious
4596,32935,23,Yes,4,Yes,Online,28339,15450,20046,No,Suspicious-Needs Monitoring
4835,42641,14,No,6,Yes,Online,37806,45927,50762,No,No Suspicious
4655,34711,8,Yes,3,Yes,ATM,30056,39841,44496,No,No Suspicious
9246,9806,22,No,8,Yes,Online,560,27554,36800,No,No Suspicious
8150,46360,18,No,2,No,ATM,38210,36826,44976,Yes,Highly Suspicious
3546,17182,8,Yes,5,Yes,POS,13636,47879,51425,No,No Suspicious
1145,27297,2,No,1,Yes,Wire,26152,11825,12970,No,No Suspicious
6993,24541,20,No,6,Yes,Online,17548,48420,55413,No,No Suspicious
1793,33921,8,No,2,No,Wire,32128,17454,19247,No,No Suspicious
3536,21774,13,No,4,Yes,ATM,18238,29251,32787,No,No Suspicious
8854,49813,18,No,6,Yes,POS,40959,25648,34502,No,No Suspicious
5995,42198,6,No,8,No,POS,36203,45736,51731,No,Suspicious-Needs Monitoring
3454,13820,15,Yes,8,No,POS,10366,29530,32984,No,Highly Suspicious
325,29070,15,Yes,6,Yes,Wire,28745,17516,17841,No,Suspicious-Needs Monitoring
4993,9232,0,No,4,Yes,ATM,4239,45544,50537,No,No Suspicious
7122,16122,3,No,8,No,Online,9000,13558,20680,No,Highly Suspicious
9251,20023,3,No,8,Yes,Online,10772,13719,22970,No,Suspicious-Needs Monitoring
5700,13007,6,No,1,Yes,ATM,7307,9886,15586,No,No Suspicious
8096,22905,7,No,4,Yes,Wire,14809,33185,41281,No,No Suspicious
9107,46786,16,No,4,No,Online,37679,42387,51494,No,No Suspicious
7783,34398,4,No,7,Yes,ATM,26615,26575,34358,No,Suspicious-Needs Monitoring
4742,39268,6,No,7,No,Online,34526,48113,52855,No,Suspicious-Needs Monitoring
7779,11737,19,No,8,Yes,POS,3958,44643,52422,No,No Suspicious
8308,41062,19,No,5,Yes,Online,32754,15100,23408,No,No Suspicious
7439,30510,3,No,7,Yes,Wire,23071,12856,20295,No,Suspicious-Needs Monitoring
9535,24426,5,No,8,Yes,ATM,14891,43169,52704,No,No Suspicious
2305,42265,6,Yes,9,No,Wire,39960,33804,36109,No,Highly Suspicious
1169,22850,17,Yes,3,No,ATM,21681,40790,41959,Yes,Highly Suspicious
3544,5614,4,No,3,Yes,POS,2070,35988,39532,No,No Suspicious
1160,26776,19,No,4,Yes,ATM,25616,49443,50603,No,No Suspicious
2427,29077,2,No,5,Yes,Online,26650,15912,18339,No,No Suspicious
3520,14374,6,No,1,Yes,Online,10854,43506,47026,No,No Suspicious
401,40435,21,Yes,7,Yes,POS,40034,27368,27769,No,Suspicious-Needs Monitoring
706,35907,13,No,9,Yes,ATM,35201,6770,7476,No,No Suspicious
3270,18409,6,No,8,Yes,POS,15139,17305,20575,No,No Suspicious
799,21514,4,No,5,No,Online,20715,14969,15768,No,Suspicious-Needs Monitoring
5188,34866,21,No,4,No,Wire,29678,17404,22592,No,No Suspicious
9431,7983,4,No,7,Yes,POS,-1448,13989,23420,No,Suspicious-Needs Monitoring
290,36705,22,Yes,5,No,Wire,36415,40983,41273,No,Suspicious-Needs Monitoring
1080,25662,1,No,7,Yes,Wire,24582,49748,50828,Yes,Highly Suspicious
3075,28510,20,No,1,Yes,ATM,25435,44462,47537,No,No Suspicious
6202,17651,21,No,1,Yes,POS,11449,24360,30562,No,No Suspicious
1284,45998,5,No,3,Yes,Wire,44714,25121,26405,No,No Suspicious
3427,33535,14,Yes,2,Yes,Wire,30108,31287,34714,Yes,Highly Suspicious
3494,11640,20,Yes,2,Yes,ATM,8146,48429,51923,No,No Suspicious
8419,49547,9,No,7,No,ATM,41128,39160,47579,No,Suspicious-Needs Monitoring
1916,20317,22,No,2,No,Online,18401,11789,13705,No,No Suspicious
5954,12564,23,Yes,4,Yes,Wire,6610,32181,38135,No,Suspicious-Needs Monitoring
6809,32345,6,Yes,2,No,Online,25536,19385,26194,No,Suspicious-Needs Monitoring
669,33687,4,No,6,Yes,Wire,33018,22061,22730,No,Suspicious-Needs Monitoring
5542,18737,0,Yes,8,Yes,Online,13195,5105,10647,No,Highly Suspicious
1995,14323,12,No,4,Yes,ATM,12328,49247,51242,No,No Suspicious
2833,20229,20,No,5,Yes,POS,17396,26137,28970,No,No Suspicious
3963,49481,17,No,4,Yes,ATM,45518,39714,43677,No,No Suspicious
7555,13502,12,Yes,3,Yes,Online,5947,10544,18099,No,No Suspicious
4114,5545,20,Yes,5,Yes,Online,1431,18275,22389,No,No Suspicious
1786,42114,20,No,9,No,POS,40328,44753,46539,No,Suspicious-Needs Monitoring
3109,34430,17,No,8,Yes,Wire,31321,39550,42659,No,No Suspicious
7906,14996,4,No,8,Yes,Online,7090,24641,32547,No,Suspicious-Needs Monitoring
254,32788,12,Yes,8,Yes,Online,32534,11213,11467,No,Suspicious-Needs Monitoring
1509,34969,3,No,8,Yes,Online,33460,19485,20994,No,Suspicious-Needs Monitoring
884,18919,16,No,7,Yes,POS,18035,20605,21489,No,No Suspicious
8196,8810,2,No,8,No,ATM,614,42637,50833,No,Highly Suspicious
7660,35586,16,No,8,Yes,Online,27926,25390,33050,No,No Suspicious
7443,44974,10,No,8,Yes,POS,37531,14867,22310,Yes,Highly Suspicious
7306,46773,20,No,7,Yes,Online,39467,8981,16287,No,No Suspicious
5696,21371,19,Yes,1,Yes,Wire,15675,14493,20189,No,No Suspicious
5901,34629,22,No,4,Yes,POS,28728,10682,16583,No,No Suspicious
2906,13436,20,Yes,4,Yes,Online,10530,10782,13688,No,No Suspicious
637,17984,3,No,5,No,POS,17347,34799,35436,No,Suspicious-Needs Monitoring
6086,38039,1,No,6,Yes,Online,31953,46905,52991,Yes,Highly Suspicious
1941,24895,19,Yes,4,Yes,ATM,22954,21984,23925,No,No Suspicious
8816,23155,15,No,2,Yes,Online,14339,27760,36576,No,No Suspicious
7071,15616,17,Yes,6,Yes,POS,8545,30993,38064,No,Suspicious-Needs Monitoring
5725,42129,7,No,8,Yes,Wire,36404,6524,12249,No,No Suspicious
3050,44837,2,No,8,No,Wire,41787,31120,34170,Yes,Highly Suspicious
8092,29574,8,Yes,7,Yes,Wire,21482,5078,13170,No,Suspicious-Needs Monitoring
4880,8430,19,No,6,Yes,Online,3550,40891,45771,No,No Suspicious
2468,17676,5,No,2,Yes,ATM,15208,30473,32941,No,No Suspicious
6755,15816,9,Yes,7,Yes,Online,9061,44832,51587,Yes,Highly Suspicious
8273,37733,20,Yes,5,Yes,Wire,29460,13417,21690,No,No Suspicious
4595,25144,9,No,6,Yes,POS,20549,18362,22957,Yes,Highly Suspicious
9263,7050,12,No,8,Yes,Wire,-2213,6209,15472,No,No Suspicious
6102,49460,16,No,8,Yes,POS,43358,42921,49023,No,No Suspicious
6714,38933,8,Yes,3,No,ATM,32219,9898,16612,No,Suspicious-Needs Monitoring
9458,29951,16,Yes,7,Yes,POS,20493,23562,33020,No,Suspicious-Needs Monitoring
6019,37413,23,No,1,Yes,Online,31394,15871,21890,No,No Suspicious
953,39801,8,Yes,1,Yes,Online,38848,12610,13563,No,No Suspicious
4246,37913,8,Yes,7,Yes,Online,33667,48845,53091,No,Suspicious-Needs Monitoring
3869,45600,0,Yes,9,Yes,POS,41731,32382,36251,No,Highly Suspicious
674,30280,1,No,7,Yes,Online,29606,20791,21465,No,Suspicious-Needs Monitoring
1248,29557,15,No,5,Yes,Online,28309,40312,41560,Yes,Highly Suspicious
6393,40400,0,No,8,Yes,Online,34007,43290,49683,No,Suspicious-Needs Monitoring
6557,9494,9,No,2,Yes,ATM,2937,7370,13927,No,No Suspicious
7609,20152,17,No,9,Yes,POS,12543,24665,32274,No,No Suspicious
4877,28895,7,No,6,No,POS,24018,9710,14587,No,Suspicious-Needs Monitoring
3954,14155,20,Yes,9,Yes,Wire,10201,5328,9282,No,Suspicious-Needs Monitoring
2591,36883,10,No,2,Yes,POS,34292,43347,45938,No,No Suspicious
3224,48194,22,No,3,Yes,ATM,44970,25612,28836,No,No Suspicious
5791,48001,1,No,8,Yes,POS,42210,11794,17585,No,Suspicious-Needs Monitoring
3151,6828,7,No,1,Yes,ATM,3677,37888,41039,No,No Suspicious
104,46898,21,No,7,Yes,ATM,46794,11749,11853,Yes,Highly Suspicious
5322,37123,7,Yes,7,No,POS,31801,25608,30930,No,Highly Suspicious
5415,42573,16,No,1,Yes,Wire,37158,20450,25865,No,No Suspicious
4969,5806,14,No,9,Yes,Online,837,8675,13644,No,No Suspicious
976,45970,16,No,8,Yes,Online,44994,23460,24436,No,No Suspicious
9283,34757,22,No,4,Yes,POS,25474,43411,52694,No,No Suspicious
7127,39636,23,No,5,Yes,POS,32509,16560,23687,Yes,Highly Suspicious
4242,19561,12,Yes,2,No,ATM,15319,37463,41705,Yes,Highly Suspicious
7066,29262,18,No,9,Yes,POS,22196,36663,43729,No,No Suspicious
7179,19899,4,Yes,6,No,ATM,12720,8170,15349,No,Highly Suspicious
8087,20934,11,No,3,No,Wire,12847,38123,46210,No,No Suspicious
6899,43197,0,No,7,No,POS,36298,33810,40709,No,Highly Suspicious
4565,46844,22,No,9,Yes,Online,42279,14718,19283,No,No Suspicious
735,41332,4,No,3,Yes,Online,40597,5028,5763,No,No Suspicious
1793,39157,7,No,2,Yes,POS,37364,22397,24190,No,No Suspicious
9974,16593,12,Yes,7,Yes,ATM,6619,48662,58636,No,Suspicious-Needs Monitoring
4852,45042,7,No,7,Yes,Online,40190,46787,51639,No,No Suspicious
8411,22320,22,Yes,4,No,ATM,13909,7024,15435,No,Suspicious-Needs Monitoring
930,32376,10,No,9,Yes,POS,31446,43607,44537,No,No Suspicious
5277,48513,0,Yes,8,Yes,POS,43236,18503,23780,No,Highly Suspicious
9661,19199,12,Yes,1,Yes,Online,9538,15303,24964,No,No Suspicious
9032,20876,18,No,1,Yes,POS,11844,22138,31170,No,No Suspicious
8408,13245,23,Yes,5,Yes,Wire,4837,30345,38753,No,Suspicious-Needs Monitoring
6049,12214,2,No,6,No,Wire,6165,34505,40554,No,Highly Suspicious
2938,5726,23,No,3,Yes,Online,2788,6906,9844,No,No Suspicious
1250,16362,16,Yes,9,No,Wire,15112,45167,46417,No,Highly Suspicious
7660,23297,4,No,6,No,ATM,15637,12961,20621,No,Highly Suspicious
2031,35448,19,Yes,4,No,Online,33417,31140,33171,No,Suspicious-Needs Monitoring
9304,31172,20,Yes,7,Yes,Online,21868,17031,26335,No,Suspicious-Needs Monitoring
1764,47874,7,No,8,No,ATM,46110,20128,21892,No,Suspicious-Needs Monitoring
1181,12657,13,Yes,9,Yes,Wire,11476,20663,21844,No,Suspicious-Needs Monitoring
612,23850,3,No,6,Yes,Wire,23238,39228,39840,No,Suspicious-Needs Monitoring
7905,30425,10,Yes,6,Yes,Wire,22520,20682,28587,Yes,Highly Suspicious
5337,31685,19,Yes,8,Yes,Online,26348,20193,25530,No,Suspicious-Needs Monitoring
659,29578,14,No,5,Yes,Online,28919,33561,34220,No,No Suspicious
3772,33831,18,No,3,Yes,Wire,30059,48813,52585,No,No Suspicious
7504,12906,6,Yes,3,Yes,POS,5402,12766,20270,No,No Suspicious
3443,12287,18,No,6,No,Wire,8844,34844,38287,No,Suspicious-Needs Monitoring
4170,38660,18,Yes,2,Yes,ATM,34490,34432,38602,No,No Suspicious
9762,15222,10,No,6,Yes,Online,5460,34504,44266,No,No Suspicious
680,42443,4,No,6,Yes,ATM,41763,42146,42826,No,Suspicious-Needs Monitoring
7104,39701,4,No,8,Yes,ATM,32597,45297,52401,No,Suspicious-Needs Monitoring
8230,22764,21,No,7,No,Online,14534,25858,34088,No,Suspicious-Needs Monitoring
3247,49641,7,No,8,Yes,POS,46394,8071,11318,No,No Suspicious
4349,22674,9,No,9,Yes,Wire,18325,21939,26288,No,No Suspicious
1779,23024,5,No,6,Yes,ATM,21245,29931,31710,No,No Suspicious
3606,28874,14,No,3,No,Online,25268,49460,53066,No,No Suspicious
7353,48642,15,Yes,3,Yes,ATM,41289,6040,13393,No,No Suspicious
2844,37284,16,No,1,No,Wire,34440,7686,10530,No,No Suspicious
9535,22602,7,No,5,Yes,POS,13067,17666,27201,No,No Suspicious
5288,42784,7,No,4,Yes,POS,37496,40321,45609,No,No Suspicious
2241,28265,8,No,9,Yes,POS,26024,6779,9020,Yes,Highly Suspicious
6717,30931,1,No,9,No,Online,24214,18186,24903,No,Highly Suspicious
2579,33841,14,Yes,5,Yes,Online,31262,21459,24038,Yes,Highly Suspicious
6584,34192,17,Yes,4,Yes,POS,27608,25710,32294,No,No Suspicious
9927,47520,2,No,7,Yes,Wire,37593,27219,37146,No,Suspicious-Needs Monitoring
7521,20585,16,No,6,Yes,Wire,13064,10057,17578,No,No Suspicious
4552,30559,3,No,4,Yes,Online,26007,23733,28285,No,No Suspicious
5981,45059,3,No,2,No,POS,39078,24157,30138,No,Suspicious-Needs Monitoring
6765,38742,13,No,1,Yes,Wire,31977,40030,46795,No,No Suspicious
2949,9133,8,No,4,Yes,Wire,6184,24613,27562,No,No Suspicious
7490,19663,8,Yes,4,No,Wire,12173,48076,55566,No,Suspicious-Needs Monitoring
7005,26754,22,Yes,1,Yes,Online,19749,22492,29497,No,No Suspicious
2589,8972,17,No,6,Yes,POS,6383,25746,28335,No,No Suspicious
9923,10295,9,No,4,Yes,ATM,372,10188,20111,Yes,Highly Suspicious
9307,46873,20,Yes,1,Yes,POS,37566,46570,55877,Yes,Highly Suspicious
9640,34125,3,No,1,Yes,POS,24485,34680,44320,No,No Suspicious
4711,45996,11,No,1,Yes,Online,41285,42825,47536,No,No Suspicious
2939,14903,7,No,8,Yes,Wire,11964,41766,44705,No,No Suspicious
8627,8020,1,No,8,Yes,Wire,-607,13864,22491,No,Suspicious-Needs Monitoring
5978,46755,21,No,2,No,Online,40777,41445,47423,No,No Suspicious
9187,25420,12,Yes,7,No,Online,16233,10796,19983,No,Highly Suspicious
6403,26452,20,No,8,No,Online,20049,44131,50534,No,Suspicious-Needs Monitoring
951,43001,15,No,8,No,Online,42050,13123,14074,No,Suspicious-Needs Monitoring
1787,14516,1,Yes,7,Yes,Online,12729,13222,15009,No,Highly Suspicious
6933,7396,10,No,5,No,ATM,463,29074,36007,No,No Suspicious
2527,23546,9,No,1,Yes,POS,21019,34825,37352,No,No Suspicious
9860,24129,14,No,9,Yes,POS,14269,41839,51699,No,No Suspicious
4100,6591,16,No,7,Yes,POS,2491,46576,50676,No,No Suspicious
5152,16303,7,Yes,2,Yes,Wire,11151,7786,12938,No,No Suspicious
2838,35561,17,No,6,No,ATM,32723,38638,41476,No,Suspicious-Needs Monitoring
5832,11183,22,No,2,No,POS,5351,41964,47796,No,No Suspicious
5487,31572,8,No,1,Yes,Wire,26085,49564,55051,No,No Suspicious
8102,39080,7,Yes,7,No,ATM,30978,30988,39090,No,Highly Suspicious
5636,25695,13,No,2,Yes,ATM,20059,40507,46143,Yes,Highly Suspicious
4013,12314,17,No,2,Yes,Wire,8301,38708,42721,No,No Suspicious
1166,24623,21,Yes,5,Yes,ATM,23457,38108,39274,No,No Suspicious
7823,7139,19,Yes,5,Yes,Wire,-684,34715,42538,No,No Suspicious
4480,36290,19,No,7,No,POS,31810,28806,33286,No,Suspicious-Needs Monitoring
4207,23088,20,No,1,No,Wire,18881,41901,46108,No,No Suspicious
5826,44692,11,No,8,No,ATM,38866,22043,27869,No,Suspicious-Needs Monitoring
3473,38130,18,No,3,Yes,POS,34657,15225,18698,No,No Suspicious
9045,37088,13,No,4,No,POS,28043,14752,23797,No,No Suspicious
2182,31292,16,No,9,Yes,Online,29110,8457,10639,No,No Suspicious
9067,25670,23,Yes,4,No,Online,16603,47616,56683,No,Highly Suspicious
6848,8738,20,No,5,Yes,ATM,1890,14241,21089,No,No Suspicious
9917,7469,2,Yes,7,Yes,Wire,-2448,5453,15370,Yes,Highly Suspicious
517,27534,22,No,4,Yes,Wire,27017,14896,15413,No,No Suspicious
8406,14017,6,Yes,1,Yes,ATM,5611,26826,35232,No,No Suspicious
8908,7808,16,Yes,9,Yes,POS,-1100,15976,24884,No,Suspicious-Needs Monitoring
4074,17713,11,No,4,Yes,ATM,13639,38586,42660,No,No Suspicious
3367,45329,8,Yes,9,Yes,ATM,41962,9868,13235,No,Suspicious-Needs Monitoring
925,7719,14,No,6,Yes,POS,6794,21396,22321,Yes,Highly Suspicious
7768,27890,17,Yes,1,Yes,Wire,20122,36634,44402,No,No Suspicious
5845,16700,20,No,3,Yes,ATM,10855,17171,23016,No,No Suspicious
9808,41509,12,No,2,Yes,Wire,31701,29111,38919,No,No Suspicious
512,47534,20,Yes,9,Yes,ATM,47022,38688,39200,No,Suspicious-Needs Monitoring
7643,41766,7,Yes,1,Yes,POS,34123,26304,33947,Yes,Highly Suspicious
7687,31705,13,No,9,No,POS,24018,47274,54961,No,Suspicious-Needs Monitoring
828,23787,7,No,9,No,Online,22959,44243,45071,No,Suspicious-Needs Monitoring
7264,31588,13,No,8,Yes,POS,24324,33253,40517,No,No Suspicious
8967,31123,6,No,8,No,Online,22156,35980,44947,No,Suspicious-Needs Monitoring
6088,38062,22,No,1,No,ATM,31974,7017,13105,No,No Suspicious
2604,15177,11,Yes,8,No,Wire,12573,12957,15561,Yes,Highly Suspicious
3067,26727,10,No,3,Yes,POS,23660,47188,50255,No,No Suspicious
2886,35220,21,No,7,Yes,POS,32334,9792,12678,No,No Suspicious
1222,14882,21,No,1,Yes,POS,13660,18237,19459,Yes,Highly Suspicious
4179,6136,10,No,1,Yes,ATM,1957,21251,25430,No,No Suspicious
1671,39832,21,No,5,Yes,Online,38161,24252,25923,No,No Suspicious
5173,36966,12,No,5,Yes,ATM,31793,15707,20880,No,No Suspicious
5204,12009,17,No,8,No,Wire,6805,39206,44410,No,Suspicious-Needs Monitoring
2243,17987,1,No,7,No,ATM,15744,33740,35983,No,Highly Suspicious
9979,42311,20,No,8,Yes,Wire,32332,8543,18522,No,No Suspicious
6906,36575,14,Yes,6,Yes,POS,29669,49135,56041,No,Suspicious-Needs Monitoring
7457,6007,19,Yes,6,Yes,Wire,-1450,44111,51568,Yes,Highly Suspicious
3540,10445,17,No,2,No,Wire,6905,40031,43571,No,No Suspicious
3866,15706,14,No,6,Yes,Online,11840,47929,51795,No,No Suspicious
5744,49486,18,Yes,5,Yes,Wire,43742,5211,10955,No,No Suspicious
3014,34257,22,Yes,3,Yes,Wire,31243,44795,47809,No,No Suspicious
5068,26736,23,Yes,6,Yes,ATM,21668,5331,10399,No,Highly Suspicious
6017,47207,11,Yes,8,Yes,POS,41190,28244,34261,No,Suspicious-Needs Monitoring
8887,18281,12,No,9,Yes,ATM,9394,13169,22056,No,No Suspicious
828,6435,21,No,1,No,ATM,5607,27104,27932,No,No Suspicious
1465,38339,10,No,3,No,POS,36874,46901,48366,No,No Suspicious
4592,40150,4,No,3,No,POS,35558,19591,24183,No,Suspicious-Needs Monitoring
798,30821,0,Yes,8,No,Wire,30023,36711,37509,No,Highly Suspicious
7286,31660,23,Yes,1,Yes,Wire,24374,5727,13013,No,Suspicious-Needs Monitoring
495,10084,2,No,5,Yes,Online,9589,26359,26854,No,No Suspicious
7500,21661,21,No,3,No,ATM,14161,48822,56322,No,No Suspicious
8182,18507,18,No,2,No,POS,10325,41011,49193,No,No Suspicious
4271,12059,22,Yes,8,Yes,Wire,7788,42863,47134,No,Suspicious-Needs Monitoring
4460,23271,6,No,3,Yes,POS,18811,27998,32458,No,No Suspicious
2602,12491,11,No,7,Yes,Wire,9889,15929,18531,No,No Suspicious
817,19859,14,No,1,Yes,Online,19042,19842,20659,No,No Suspicious
2882,13073,4,No,6,Yes,Online,10191,28519,31401,No,Suspicious-Needs Monitoring
5046,14077,14,No,3,Yes,POS,9031,22393,27439,No,No Suspicious
5586,25953,7,No,8,Yes,Online,20367,39318,44904,No,No Suspicious
8435,16383,9,Yes,6,Yes,POS,7948,13995,22430,No,Suspicious-Needs Monitoring
5080,7353,15,Yes,2,No,Wire,2273,33656,38736,No,Suspicious-Needs Monitoring
7366,28821,7,Yes,6,Yes,ATM,21455,45260,52626,No,Suspicious-Needs Monitoring
4591,42567,0,No,7,Yes,Online,37976,20567,25158,Yes,Highly Suspicious
7292,29860,11,No,5,Yes,Wire,22568,33840,41132,No,No Suspicious
5688,26195,4,No,3,No,ATM,20507,28831,34519,No,Suspicious-Needs Monitoring
7751,16939,2,Yes,4,Yes,ATM,9188,18265,26016,No,Suspicious-Needs Monitoring
3736,30338,0,No,4,No,ATM,26602,10424,14160,No,Suspicious-Needs Monitoring
1267,26730,3,No,6,Yes,Wire,25463,25625,26892,Yes,Highly Suspicious
1162,26427,7,No,1,No,Wire,25265,19086,20248,No,No Suspicious
2256,40196,2,No,4,No,POS,37940,34187,36443,No,Suspicious-Needs Monitoring
7960,32083,9,No,4,Yes,ATM,24123,40929,48889,Yes,Highly Suspicious
5261,26510,1,No,1,Yes,ATM,21249,25539,30800,No,No Suspicious
5405,49064,10,Yes,9,Yes,ATM,43659,30103,35508,No,Suspicious-Needs Monitoring
6641,12813,9,No,4,Yes,POS,6172,32874,39515,No,No Suspicious
4829,36598,20,Yes,7,Yes,ATM,31769,14215,19044,No,Suspicious-Needs Monitoring
9448,32570,13,Yes,3,Yes,Wire,23122,44385,53833,No,No Suspicious
7430,32082,6,Yes,3,Yes,ATM,24652,27044,34474,No,No Suspicious
5434,34241,1,No,8,Yes,Online,28807,16926,22360,No,Suspicious-Needs Monitoring
9024,35678,8,No,8,Yes,Wire,26654,36501,45525,No,No Suspicious
4430,49569,15,No,1,Yes,POS,45139,34774,39204,No,No Suspicious
8110,16745,12,Yes,2,Yes,ATM,8635,30008,38118,No,No Suspicious
6901,31029,8,No,8,Yes,Online,24128,22560,29461,No,No Suspicious
4946,18025,19,No,1,Yes,POS,13079,29340,34286,No,No Suspicious
6831,41124,3,No,8,Yes,POS,34293,29976,36807,No,Suspicious-Needs Monitoring
7341,19288,21,No,8,No,Wire,11947,32626,39967,No,Suspicious-Needs Monitoring
1053,28650,9,Yes,2,Yes,POS,27597,37720,38773,No,No Suspicious
2639,11540,21,No,4,Yes,POS,8901,40001,42640,Yes,Highly Suspicious
7156,37232,11,No,6,Yes,POS,30076,9700,16856,No,No Suspicious
1642,21422,16,Yes,9,No,POS,19780,48795,50437,No,Highly Suspicious
5393,8342,13,No,8,No,ATM,2949,12860,18253,No,Suspicious-Needs Monitoring
1291,46846,13,No,8,No,ATM,45555,12526,13817,Yes,Highly Suspicious
6413,40612,1,No,7,Yes,ATM,34199,43327,49740,No,Suspicious-Needs Monitoring
7038,15396,20,Yes,9,Yes,ATM,8358,44500,51538,No,Suspicious-Needs Monitoring
2781,22482,19,Yes,2,Yes,Online,19701,7513,10294,No,No Suspicious
9509,28411,10,Yes,3,Yes,ATM,18902,12830,22339,No,No Suspicious
1640,18261,15,No,8,No,POS,16621,19781,21421,No,Suspicious-Needs Monitoring
6272,8093,18,No,6,Yes,ATM,1821,12910,19182,Yes,Highly Suspicious
5641,16722,22,Yes,9,No,ATM,11081,20847,26488,No,Highly Suspicious
9680,27042,5,No,4,Yes,Wire,17362,10649,20329,No,No Suspicious
1465,49413,23,No,8,No,POS,47948,14120,15585,No,Highly Suspicious
8791,33087,18,Yes,3,Yes,ATM,24296,6951,15742,No,No Suspicious
9972,37347,4,No,3,Yes,ATM,27375,15165,25137,No,No Suspicious
8802,38756,3,No,8,Yes,ATM,29954,19352,28154,No,Suspicious-Needs Monitoring
7594,44214,14,Yes,5,Yes,Online,36620,14746,22340,No,No Suspicious
4412,21335,3,Yes,3,Yes,ATM,16923,48738,53150,No,Suspicious-Needs Monitoring
1424,33602,19,No,1,No,Wire,32178,33997,35421,No,No Suspicious
9447,39450,9,No,3,Yes,POS,30003,46954,56401,No,No Suspicious
3241,37196,23,No,9,Yes,POS,33955,29183,32424,No,Suspicious-Needs Monitoring
7519,10626,21,No,5,Yes,ATM,3107,13804,21323,Yes,Highly Suspicious
3586,12424,2,Yes,2,Yes,ATM,8838,32169,35755,No,Suspicious-Needs Monitoring
1910,17857,4,Yes,7,No,ATM,15947,5595,7505,No,Highly Suspicious
6688,49923,5,No,2,No,POS,43235,34592,41280,No,No Suspicious
3023,24982,20,Yes,4,No,POS,21959,45643,48666,No,Suspicious-Needs Monitoring
5401,16425,21,Yes,7,No,Online,11024,25823,31224,No,Highly Suspicious
4286,6980,7,No,4,No,Wire,2694,10972,15258,Yes,Highly Suspicious
9005,31431,6,No,7,Yes,Online,22426,20882,29887,No,No Suspicious
6077,24440,20,No,7,No,Wire,18363,5858,11935,No,Suspicious-Needs Monitoring
4368,46752,9,No,1,Yes,Online,42384,10519,14887,No,No Suspicious
4848,22175,5,Yes,6,Yes,POS,17327,28769,33617,Yes,Highly Suspicious
4949,31385,13,No,9,Yes,Online,26436,30020,34969,No,No Suspicious
9535,43158,3,Yes,2,No,Wire,33623,47748,57283,No,Highly Suspicious
3809,28019,12,No,3,No,ATM,24210,42085,45894,No,No Suspicious
9373,23639,19,No,5,Yes,Wire,14266,24838,34211,No,No Suspicious
6719,24994,16,No,9,No,ATM,18275,49912,56631,No,Suspicious-Needs Monitoring
8747,39375,22,No,4,No,POS,30628,17879,26626,No,No Suspicious
9186,26563,6,No,1,Yes,Wire,17377,38798,47984,No,No Suspicious
9676,44341,3,Yes,4,Yes,Online,34665,47255,56931,No,Suspicious-Needs Monitoring
3172,10776,13,No,6,No,Wire,7604,29290,32462,No,Suspicious-Needs Monitoring
6630,41444,2,No,5,Yes,ATM,34814,15255,21885,No,No Suspicious
604,8380,23,Yes,1,Yes,POS,7776,6447,7051,No,Suspicious-Needs Monitoring
1314,13711,4,No,4,Yes,Online,12397,48005,49319,No,No Suspicious
1631,13782,15,No,6,Yes,Wire,12151,34195,35826,No,No Suspicious
7676,22434,22,Yes,4,No,ATM,14758,7850,15526,No,Suspicious-Needs Monitoring
923,25017,19,No,9,Yes,Online,24094,33400,34323,No,No Suspicious
1028,35707,3,No,5,No,POS,34679,16953,17981,No,Suspicious-Needs Monitoring
5129,44110,23,No,8,No,Online,38981,45874,51003,No,Highly Suspicious
233,22343,23,No,9,No,POS,22110,28535,28768,No,Highly Suspicious
2205,43827,1,No,5,Yes,Online,41622,15000,17205,Yes,Highly Suspicious
3727,46652,17,No,6,Yes,Wire,42925,14503,18230,No,No Suspicious
6416,10655,18,No,1,Yes,ATM,4239,20493,26909,No,No Suspicious
1952,49859,18,Yes,7,Yes,Wire,47907,9055,11007,No,Suspicious-Needs Monitoring
5010,20251,16,No,4,No,Wire,15241,43170,48180,No,No Suspicious
4275,5526,13,No,2,Yes,POS,1251,37408,41683,No,No Suspicious
5448,8224,18,Yes,5,Yes,POS,2776,47049,52497,No,No Suspicious
9542,16536,21,No,3,Yes,POS,6994,39440,48982,Yes,Highly Suspicious
6290,33541,23,No,6,No,Wire,27251,33251,39541,No,Highly Suspicious
1356,18547,12,Yes,8,No,Online,17191,9532,10888,No,Highly Suspicious
3476,39531,11,No,7,Yes,Online,36055,9924,13400,No,No Suspicious
5745,13712,5,No,3,No,Wire,7967,17546,23291,No,No Suspicious
3586,43565,20,No,8,Yes,Wire,39979,31579,35165,No,No Suspicious
3684,14208,3,Yes,2,Yes,ATM,10524,11085,14769,No,Suspicious-Needs Monitoring
9688,10109,18,Yes,9,No,POS,421,17390,27078,No,Highly Suspicious
8153,40201,15,No,4,Yes,POS,32048,18280,26433,No,No Suspicious
3430,21967,12,No,1,No,Wire,18537,29118,32548,No,No Suspicious
2803,34759,3,Yes,8,Yes,Wire,31956,9864,12667,Yes,Highly Suspicious
8762,25172,22,No,7,Yes,Online,16410,47084,55846,No,No Suspicious
8220,41935,16,Yes,5,No,Wire,33715,38989,47209,No,Suspicious-Needs Monitoring
7214,31589,22,No,5,Yes,Online,24375,40628,47842,No,No Suspicious
1453,35015,0,No,7,No,Wire,33562,31849,33302,Yes,Highly Suspicious
5163,34009,17,No,5,No,ATM,28846,32566,37729,No,No Suspicious
8649,22773,19,Yes,8,Yes,ATM,14124,15702,24351,No,Suspicious-Needs Monitoring
7675,46125,16,No,6,Yes,Online,38450,46196,53871,No,No Suspicious
767,31143,14,Yes,5,Yes,POS,30376,20385,21152,No,No Suspicious
4568,11154,10,No,9,Yes,ATM,6586,14336,18904,No,No Suspicious
9437,26804,21,No,2,Yes,Online,17367,36225,45662,No,No Suspicious
6919,46688,12,Yes,1,Yes,Wire,39769,41021,47940,Yes,Highly Suspicious
3819,25581,0,Yes,8,Yes,Wire,21762,8782,12601,No,Highly Suspicious
2845,35087,16,No,3,Yes,Online,32242,28341,31186,No,No Suspicious
7583,37981,5,No,7,No,POS,30398,29094,36677,No,Suspicious-Needs Monitoring
639,8762,3,No,8,No,Online,8123,28866,29505,No,Highly Suspicious
5064,14768,19,Yes,6,No,Online,9704,24049,29113,No,Highly Suspicious
4935,48408,15,No,9,Yes,ATM,43473,47719,52654,No,No Suspicious
3875,44499,14,No,7,No,Online,40624,35992,39867,Yes,Highly Suspicious
6142,43559,14,No,5,Yes,Online,37417,19567,25709,No,No Suspicious
7202,13783,5,No,8,No,Wire,6581,49451,56653,No,Suspicious-Needs Monitoring
7412,34781,14,No,2,No,ATM,27369,8513,15925,No,No Suspicious
5420,35811,13,No,7,Yes,Wire,30391,18335,23755,No,No Suspicious
6232,40488,10,No,4,Yes,Wire,34256,49140,55372,No,No Suspicious
7991,13905,6,No,9,No,POS,5914,43590,51581,No,Suspicious-Needs Monitoring
2879,14127,8,No,1,No,POS,11248,19837,22716,No,No Suspicious
1024,27431,15,Yes,7,No,ATM,26407,17122,18146,No,Highly Suspicious
1681,11368,4,No,6,Yes,ATM,9687,39840,41521,No,Suspicious-Needs Monitoring
7814,32424,19,No,8,Yes,POS,24610,36007,43821,Yes,Highly Suspicious
3424,23333,9,No,5,Yes,POS,19909,46297,49721,No,No Suspicious
5813,28116,17,Yes,1,No,POS,22303,32684,38497,No,Suspicious-Needs Monitoring
7126,48201,2,Yes,1,Yes,POS,41075,31393,38519,No,Suspicious-Needs Monitoring
355,20525,12,No,9,No,POS,20170,27754,28109,No,Suspicious-Needs Monitoring
4904,28398,10,Yes,6,Yes,Wire,23494,25799,30703,No,Suspicious-Needs Monitoring
1938,37857,16,No,5,Yes,ATM,35919,43727,45665,No,No Suspicious
109,15361,21,Yes,1,Yes,Wire,15252,14107,14216,No,No Suspicious
2971,21369,12,Yes,6,No,Wire,18398,10993,13964,No,Highly Suspicious
9089,8041,5,Yes,6,Yes,Online,-1048,35805,44894,Yes,Highly Suspicious
7509,5105,16,Yes,3,Yes,Wire,-2404,33114,40623,No,No Suspicious
7518,14078,12,No,8,Yes,POS,6560,42789,50307,No,No Suspicious
5224,30003,18,Yes,1,Yes,POS,24779,47942,53166,No,No Suspicious
1115,11090,20,No,1,Yes,Online,9975,21138,22253,No,No Suspicious
2293,43850,18,No,6,No,Online,41557,49527,51820,No,Suspicious-Needs Monitoring
8515,6925,9,No,1,Yes,Online,-1590,14190,22705,No,No Suspicious
7549,23440,2,No,6,Yes,Online,15891,31723,39272,No,Suspicious-Needs Monitoring
4258,44685,13,No,1,No,Online,40427,17886,22144,No,No Suspicious
4025,31015,18,No,6,No,Wire,26990,21779,25804,No,Suspicious-Needs Monitoring
7070,38320,4,Yes,3,Yes,Online,31250,33174,40244,No,Suspicious-Needs Monitoring
7038,30291,4,No,8,Yes,Wire,23253,34086,41124,No,Suspicious-Needs Monitoring
4884,41679,19,No,6,No,ATM,36795,22322,27206,No,Suspicious-Needs Monitoring
4100,31289,16,No,1,No,Online,27189,47596,51696,No,No Suspicious
1733,8389,20,No,5,No,Online,6656,40278,42011,No,No Suspicious
7366,30683,9,No,8,Yes,Wire,23317,23033,30399,No,No Suspicious
8802,18629,4,No,3,Yes,ATM,9827,25074,33876,No,No Suspicious
484,29826,3,No,6,No,Wire,29342,8435,8919,No,Highly Suspicious
504,40198,5,No,5,Yes,Wire,39694,40969,41473,No,No Suspicious
8275,31630,3,Yes,6,Yes,Online,23355,33942,42217,No,Highly Suspicious
2100,38226,6,No,1,No,POS,36126,34059,36159,No,No Suspicious
9960,37975,6,Yes,7,Yes,POS,28015,37826,47786,Yes,Highly Suspicious
6089,5899,17,No,9,Yes,Wire,-190,35297,41386,No,No Suspicious
1560,16653,2,No,2,Yes,Online,15093,48890,50450,No,No Suspicious
7290,32961,0,Yes,5,Yes,ATM,25671,26322,33612,No,Suspicious-Needs Monitoring
7240,21405,23,Yes,4,Yes,POS,14165,40739,47979,No,Suspicious-Needs Monitoring
3736,13601,3,Yes,6,No,ATM,9865,14719,18455,No,Highly Suspicious
4909,38662,5,No,6,Yes,POS,33753,19017,23926,No,No Suspicious
4278,38282,8,No,2,Yes,Online,34004,13314,17592,No,No Suspicious
7345,26288,21,No,2,No,Wire,18943,33295,40640,No,No Suspicious
6700,34545,13,No,4,Yes,ATM,27845,14628,21328,No,No Suspicious
6097,41877,11,No,1,Yes,ATM,35780,47122,53219,No,No Suspicious
2148,20313,19,No,9,No,Wire,18165,16492,18640,No,Suspicious-Needs Monitoring
4880,20349,23,No,7,No,ATM,15469,41113,45993,No,Highly Suspicious
816,12179,3,No,7,Yes,POS,11363,20357,21173,No,Suspicious-Needs Monitoring
8039,15326,20,No,3,No,Wire,7287,38329,46368,No,No Suspicious
5665,49555,23,Yes,3,Yes,POS,43890,25365,31030,No,Suspicious-Needs Monitoring
4644,6560,11,No,1,No,POS,1916,44029,48673,No,No Suspicious
5076,18612,9,No,3,Yes,Online,13536,6737,11813,No,No Suspicious
3519,22650,21,Yes,3,No,POS,19131,14096,17615,No,Suspicious-Needs Monitoring
7339,31745,6,No,4,Yes,Online,24406,24938,32277,Yes,Highly Suspicious
9866,36890,2,Yes,4,Yes,ATM,27024,17682,27548,No,Suspicious-Needs Monitoring
349,25022,22,Yes,3,Yes,ATM,24673,32499,32848,No,No Suspicious
8965,9780,13,No,8,Yes,Online,815,49491,58456,No,No Suspicious
870,23311,23,Yes,8,No,POS,22441,49866,50736,No,Highly Suspicious
4463,33380,9,No,1,Yes,Wire,28917,46894,51357,No,No Suspicious
1177,49662,15,No,7,Yes,Wire,48485,46034,47211,No,No Suspicious
8527,7356,15,Yes,2,Yes,Online,-1171,5294,13821,Yes,Highly Suspicious
8680,9790,21,No,1,Yes,ATM,1110,37536,46216,No,No Suspicious
8001,31911,9,Yes,3,No,ATM,23910,29596,37597,No,Suspicious-Needs Monitoring
4958,29363,12,No,4,No,Wire,24405,37649,42607,No,No Suspicious
6644,25049,5,No,6,Yes,Online,18405,16434,23078,No,No Suspicious
4819,15181,11,Yes,5,No,Wire,10362,43098,47917,No,Suspicious-Needs Monitoring
2914,44825,8,Yes,4,No,POS,41911,9655,12569,No,Suspicious-Needs Monitoring
3474,21082,12,No,8,Yes,POS,17608,22493,25967,No,No Suspicious
1352,5661,3,No,4,Yes,Online,4309,8771,10123,No,No Suspicious
7096,42412,23,Yes,2,No,Online,35316,13563,20659,No,Highly Suspicious
4773,7920,10,No,3,Yes,POS,3147,22558,27331,No,No Suspicious
4630,30658,19,No,6,No,ATM,26028,38932,43562,No,Suspicious-Needs Monitoring
6981,19025,17,No,8,Yes,Online,12044,47243,54224,Yes,Highly Suspicious
7049,13946,10,No,8,Yes,POS,6897,31567,38616,No,No Suspicious
9621,33706,20,No,9,Yes,POS,24085,37376,46997,No,No Suspicious
6341,44004,3,No,7,Yes,ATM,37663,26922,33263,No,Suspicious-Needs Monitoring
8117,21309,17,No,2,No,ATM,13192,17388,25505,Yes,Highly Suspicious
7041,38120,0,No,8,Yes,ATM,31079,34332,41373,Yes,Highly Suspicious
9650,35027,6,Yes,7,Yes,ATM,25377,28495,38145,No,Suspicious-Needs Monitoring
7102,12005,5,No,8,No,Wire,4903,13434,20536,No,Suspicious-Needs Monitoring
1431,5956,14,No,3,Yes,ATM,4525,25991,27422,No,No Suspicious
4361,39839,17,No,7,Yes,Wire,35478,32472,36833,No,No Suspicious
7748,13595,23,No,9,No,Online,5847,45030,52778,No,Highly Suspicious
9650,17803,10,No,3,No,POS,8153,31849,41499,No,No Suspicious
5215,30963,19,No,6,Yes,Wire,25748,6541,11756,Yes,Highly Suspicious
4737,41221,23,No,2,Yes,Online,36484,7765,12502,No,No Suspicious
4954,44443,14,No,2,Yes,Online,39489,48074,53028,No,No Suspicious
3277,38723,15,Yes,5,Yes,Wire,35446,42259,45536,Yes,Highly Suspicious
7830,44063,6,No,5,Yes,Online,36233,34283,42113,No,No Suspicious
2280,20282,20,No,7,Yes,Online,18002,40851,43131,No,No Suspicious
4992,9703,9,Yes,2,Yes,Wire,4711,39625,44617,No,No Suspicious
7143,11563,11,No,7,Yes,Online,4420,5769,12912,No,No Suspicious
237,30849,23,No,5,Yes,ATM,30612,22806,23043,Yes,Highly Suspicious
6427,36860,13,No,6,Yes,ATM,30433,29982,36409,Yes,Highly Suspicious
3572,36585,4,Yes,8,No,POS,33013,7972,11544,No,Highly Suspicious
5549,27015,20,Yes,4,No,Online,21466,23256,28805,No,Suspicious-Needs Monitoring
2932,17003,17,No,7,Yes,POS,14071,43367,46299,No,No Suspicious
3679,48585,4,Yes,6,Yes,ATM,44906,23653,27332,No,Highly Suspicious
6071,31958,2,No,2,Yes,ATM,25887,43043,49114,No,No Suspicious
4264,31017,22,No,8,Yes,ATM,26753,26133,30397,No,No Suspicious
8041,16171,4,Yes,9,Yes,Online,8130,44339,52380,No,Highly Suspicious
5669,17201,23,No,5,Yes,Online,11532,30757,36426,No,No Suspicious
4400,34426,16,No,4,Yes,ATM,30026,42840,47240,No,No Suspicious
6369,22778,18,No,6,No,POS,16409,47399,53768,No,Suspicious-Needs Monitoring
3918,47229,18,No,8,Yes,POS,43311,49013,52931,Yes,Highly Suspicious
2006,26116,20,No,3,Yes,Wire,24110,37069,39075,No,No Suspicious
6354,38297,11,No,1,No,ATM,31943,19706,26060,No,No Suspicious
860,24342,8,No,4,Yes,POS,23482,43231,44091,No,No Suspicious
7930,32490,0,No,4,Yes,ATM,24560,32909,40839,No,No Suspicious
7450,24975,17,No,1,Yes,POS,17525,45218,52668,No,No Suspicious
6338,31723,20,No,9,Yes,Wire,25385,16095,22433,No,No Suspicious
6190,28279,3,No,3,No,Wire,22089,25343,31533,No,Suspicious-Needs Monitoring
6131,17765,9,No,5,Yes,ATM,11634,31469,37600,No,No Suspicious
7787,16561,6,Yes,6,Yes,POS,8774,6313,14100,Yes,Highly Suspicious
9191,46899,21,No,8,Yes,Online,37708,12847,22038,No,No Suspicious
8572,5525,22,Yes,6,Yes,Wire,-3047,14166,22738,No,Suspicious-Needs Monitoring
1987,27861,0,No,3,No,ATM,25874,14930,16917,No,Suspicious-Needs Monitoring
3366,38142,16,No,6,No,ATM,34776,8285,11651,No,Suspicious-Needs Monitoring
766,31916,23,No,1,Yes,POS,31150,40863,41629,No,No Suspicious
4288,49965,1,No,4,Yes,ATM,45677,21704,25992,No,No Suspicious
771,9648,10,No,6,Yes,Wire,8877,23705,24476,No,No Suspicious
6877,40133,8,No,7,No,ATM,33256,5555,12432,No,Suspicious-Needs Monitoring
7670,35523,6,No,3,Yes,ATM,27853,26323,33993,No,No Suspicious
8056,34052,21,No,9,Yes,Online,25996,10432,18488,No,No Suspicious
5224,39414,16,No,7,Yes,Online,34190,6386,11610,No,No Suspicious
5685,37781,16,No,1,Yes,Wire,32096,49007,54692,No,No Suspicious
4877,9599,1,Yes,2,Yes,POS,4722,15619,20496,No,Suspicious-Needs Monitoring
4000,40046,5,No,1,Yes,Online,36046,11854,15854,No,No Suspicious
6777,40923,13,No,9,Yes,POS,34146,47964,54741,No,No Suspicious
7081,46089,5,No,9,Yes,Wire,39008,12637,19718,No,No Suspicious
6476,8814,1,Yes,7,Yes,Online,2338,26225,32701,No,Highly Suspicious
623,40984,0,No,3,No,POS,40361,31739,32362,No,Suspicious-Needs Monitoring
2493,31616,9,Yes,5,Yes,Online,29123,15618,18111,No,No Suspicious
2693,7113,20,No,4,Yes,Wire,4420,41561,44254,No,No Suspicious
7340,48006,4,No,7,Yes,Wire,40666,12373,19713,No,Suspicious-Needs Monitoring
7037,18760,1,No,9,Yes,Online,11723,40281,47318,No,Suspicious-Needs Monitoring
6290,26927,21,Yes,2,Yes,POS,20637,25187,31477,No,No Suspicious
5340,25939,15,No,8,No,ATM,20599,7327,12667,No,Suspicious-Needs Monitoring
6593,37419,1,No,9,Yes,ATM,30826,37391,43984,No,Suspicious-Needs Monitoring
2978,17588,9,No,9,No,Online,14610,46577,49555,No,Suspicious-Needs Monitoring
4243,41142,1,No,7,Yes,POS,36899,23549,27792,No,Suspicious-Needs Monitoring
3744,44198,15,Yes,9,Yes,ATM,40454,44220,47964,No,Suspicious-Needs Monitoring
4532,49738,15,No,9,Yes,Wire,45206,12642,17174,No,No Suspicious
1376,38397,18,No,3,Yes,POS,37021,19435,20811,No,No Suspicious
5911,21653,6,No,4,No,ATM,15742,38760,44671,No,No Suspicious
402,15831,21,Yes,2,No,POS,15429,43192,43594,No,Suspicious-Needs Monitoring
738,10724,11,No,3,No,Online,9986,9381,10119,No,No Suspicious
155,16083,23,No,5,No,POS,15928,36047,36202,No,Suspicious-Needs Monitoring
8817,24816,14,No,5,No,ATM,15999,24558,33375,No,No Suspicious
8250,47240,7,Yes,6,Yes,Online,38990,35782,44032,No,Suspicious-Needs Monitoring
2225,11276,5,No,7,Yes,POS,9051,9782,12007,No,No Suspicious
464,43663,9,Yes,7,Yes,Wire,43199,30881,31345,No,Suspicious-Needs Monitoring
6909,18994,2,No,1,Yes,ATM,12085,45228,52137,Yes,Highly Suspicious
4721,28499,18,Yes,2,No,Online,23778,34409,39130,No,Suspicious-Needs Monitoring
5226,28040,16,No,9,Yes,POS,22814,24462,29688,No,No Suspicious
5222,48320,6,No,2,Yes,Wire,43098,7983,13205,No,No Suspicious
1746,21959,20,No,6,Yes,ATM,20213,36933,38679,No,No Suspicious
1018,11099,19,Yes,1,Yes,Wire,10081,7523,8541,No,No Suspicious
2897,47267,3,No,3,Yes,POS,44370,14677,17574,No,No Suspicious
6606,24576,13,No,2,Yes,POS,17970,15292,21898,No,No Suspicious
5970,40946,19,No,3,Yes,Online,34976,20089,26059,No,No Suspicious
1631,11116,21,No,5,Yes,Wire,9485,9581,11212,Yes,Highly Suspicious
8272,20563,14,Yes,6,Yes,Online,12291,16907,25179,No,Suspicious-Needs Monitoring
3445,31788,23,No,9,Yes,ATM,28343,10609,14054,No,Suspicious-Needs Monitoring
7773,31928,7,Yes,4,Yes,Online,24155,49143,56916,No,No Suspicious
7049,41336,20,No,7,Yes,ATM,34287,27936,34985,No,No Suspicious
6982,14847,14,Yes,6,Yes,POS,7865,47725,54707,No,Suspicious-Needs Monitoring
2006,31155,21,No,2,Yes,POS,29149,38988,40994,No,No Suspicious
3186,19135,19,No,8,Yes,Wire,15949,34506,37692,No,No Suspicious
8252,22774,13,No,7,Yes,ATM,14522,18163,26415,No,No Suspicious
5850,6742,8,No,7,Yes,POS,892,17537,23387,No,No Suspicious
9005,23309,7,No,8,Yes,Wire,14304,27419,36424,No,No Suspicious
1162,5619,16,No,1,Yes,Wire,4457,47578,48740,No,No Suspicious
2076,22658,1,Yes,1,No,Online,20582,14455,16531,No,Highly Suspicious
1396,39707,23,No,8,Yes,Wire,38311,14063,15459,No,Suspicious-Needs Monitoring
6329,25337,2,Yes,4,No,POS,19008,5834,12163,No,Highly Suspicious
7741,21001,7,No,5,Yes,Online,13260,37214,44955,No,No Suspicious
225,5968,11,No,8,Yes,ATM,5743,32398,32623,No,No Suspicious
4732,30892,0,No,5,Yes,ATM,26160,39492,44224,No,No Suspicious
6388,30619,9,Yes,4,Yes,POS,24231,7413,13801,No,No Suspicious
3696,5281,19,No,6,Yes,POS,1585,14505,18201,No,No Suspicious
6268,32420,2,No,5,Yes,Online,26152,42266,48534,No,No Suspicious
9895,20360,5,No,7,Yes,Online,10465,7105,17000,No,No Suspicious
7661,44030,6,No,7,Yes,POS,36369,7568,15229,No,No Suspicious
8358,6058,19,No,4,Yes,POS,-2300,47098,55456,No,No Suspicious
332,25677,22,Yes,5,Yes,ATM,25345,42679,43011,No,No Suspicious
9461,15724,17,No,3,Yes,ATM,6263,38560,48021,No,No Suspicious
6471,33404,10,No,4,Yes,ATM,26933,19195,25666,No,No Suspicious
4306,42946,18,Yes,4,No,POS,38640,20762,25068,No,Suspicious-Needs Monitoring
9785,44748,4,Yes,3,No,Wire,34963,46294,56079,No,Highly Suspicious
8043,34856,18,Yes,5,No,POS,26813,20898,28941,No,Suspicious-Needs Monitoring
6991,14200,10,No,5,Yes,POS,7209,26577,33568,No,No Suspicious
6838,38997,23,No,7,No,ATM,32159,6214,13052,No,Highly Suspicious
2572,30611,11,Yes,4,No,POS,28039,25803,28375,No,Suspicious-Needs Monitoring
2839,46235,9,No,4,Yes,Online,43396,28698,31537,No,No Suspicious
5501,40057,7,Yes,9,Yes,POS,34556,37980,43481,No,Suspicious-Needs Monitoring
1861,6239,23,No,6,No,POS,4378,6658,8519,No,Highly Suspicious
976,43138,8,Yes,4,Yes,POS,42162,17270,18246,No,No Suspicious
3912,5125,3,No,2,Yes,POS,1213,42792,46704,No,No Suspicious
9604,28857,4,No,6,Yes,Wire,19253,27301,36905,No,Suspicious-Needs Monitoring
1560,20398,20,No,2,Yes,POS,18838,10141,11701,No,No Suspicious
1833,11638,7,No,5,No,Online,9805,43756,45589,No,No Suspicious
1705,11570,22,No,6,Yes,Online,9865,18777,20482,No,No Suspicious
5722,8249,8,No,4,Yes,POS,2527,43346,49068,No,No Suspicious
6867,14110,14,Yes,3,Yes,ATM,7243,34441,41308,No,No Suspicious
7086,45363,14,Yes,7,Yes,Wire,38277,33469,40555,No,Suspicious-Needs Monitoring
3617,18605,15,No,2,Yes,POS,14988,8845,12462,No,No Suspicious
3835,17115,13,Yes,6,Yes,POS,13280,49650,53485,No,Suspicious-Needs Monitoring
9452,44062,7,Yes,4,No,POS,34610,28290,37742,No,Suspicious-Needs Monitoring
8534,27911,17,No,6,Yes,ATM,19377,35699,44233,No,No Suspicious
2690,43525,9,No,4,Yes,ATM,40835,49252,51942,No,No Suspicious
1163,37556,19,No,4,Yes,ATM,36393,38146,39309,No,No Suspicious
4424,17595,5,Yes,4,Yes,Wire,13171,8293,12717,No,No Suspicious
9211,6969,11,Yes,9,No,Online,-2242,49398,58609,No,Highly Suspicious
5442,48753,1,No,7,No,Wire,43311,21608,27050,No,Highly Suspicious
105,22275,6,Yes,3,No,ATM,22170,5737,5842,No,Suspicious-Needs Monitoring
7589,9470,15,Yes,3,Yes,Online,1881,21619,29208,No,No Suspicious
8759,15225,2,No,6,Yes,Online,6466,17470,26229,Yes,Highly Suspicious
8295,47324,12,No,6,Yes,ATM,39029,27372,35667,No,No Suspicious
6066,46974,2,No,4,Yes,ATM,40908,21117,27183,Yes,Highly Suspicious
8937,47759,17,Yes,9,No,Wire,38822,19779,28716,No,Highly Suspicious
217,28196,10,Yes,4,No,ATM,27979,34294,34511,No,Suspicious-Needs Monitoring
2651,45287,7,No,9,No,Online,42636,26630,29281,No,Suspicious-Needs Monitoring
5660,18669,5,Yes,4,No,POS,13009,45039,50699,No,Suspicious-Needs Monitoring
4389,42380,0,No,2,No,ATM,37991,17178,21567,No,Suspicious-Needs Monitoring
946,43006,0,No,2,Yes,ATM,42060,24935,25881,No,No Suspicious
6416,20577,22,No,5,Yes,Wire,14161,27784,34200,No,No Suspicious
6569,27473,7,No,4,Yes,Wire,20904,28027,34596,No,No Suspicious
9433,33625,4,Yes,7,Yes,ATM,24192,36008,45441,No,Highly Suspicious
9015,20504,15,No,5,Yes,Online,11489,6823,15838,No,No Suspicious
324,29089,10,No,6,Yes,Online,28765,11852,12176,No,No Suspicious
4308,41487,4,No,4,No,POS,37179,18072,22380,No,Suspicious-Needs Monitoring
6383,5302,3,Yes,2,Yes,ATM,-1081,16133,22516,Yes,Highly Suspicious
2148,36463,5,Yes,9,No,Wire,34315,20111,22259,No,Highly Suspicious
6333,49912,13,No,7,No,Online,43579,37312,43645,No,Suspicious-Needs Monitoring
9865,34259,21,No,4,Yes,POS,24394,29161,39026,No,No Suspicious
1928,47823,18,No,3,Yes,ATM,45895,44287,46215,No,No Suspicious
2017,42208,8,Yes,3,Yes,Online,40191,6777,8794,No,No Suspicious
4334,35659,11,No,9,No,ATM,31325,29014,33348,No,Suspicious-Needs Monitoring
7088,40840,10,No,5,No,ATM,33752,19772,26860,No,No Suspicious
2126,36890,13,No,3,No,Online,34764,49627,51753,No,No Suspicious
3844,18598,22,No,5,Yes,Online,14754,23161,27005,No,No Suspicious
9193,24508,15,Yes,2,Yes,Online,15315,47264,56457,No,No Suspicious
109,47287,0,No,4,Yes,ATM,47178,12490,12599,Yes,Highly Suspicious
360,18380,12,Yes,2,No,ATM,18020,46661,47021,Yes,Highly Suspicious
6138,31984,22,No,2,Yes,POS,25846,29502,35640,No,No Suspicious
9965,49633,20,No,8,Yes,Wire,39668,40757,50722,No,No Suspicious
2319,13125,20,No,1,Yes,ATM,10806,46111,48430,No,No Suspicious
7141,41059,12,No,7,Yes,Wire,33918,37737,44878,No,No Suspicious
2160,9033,1,Yes,5,Yes,Online,6873,22709,24869,No,Suspicious-Needs Monitoring
5387,42873,3,No,8,Yes,ATM,37486,49682,55069,Yes,Highly Suspicious
1719,22087,5,No,1,Yes,POS,20368,13998,15717,No,No Suspicious
8612,45901,22,Yes,7,Yes,POS,37289,33906,42518,Yes,Highly Suspicious
1442,10704,4,Yes,5,No,Wire,9262,40490,41932,No,Highly Suspicious
2932,12848,2,No,4,No,Online,9916,9656,12588,No,Suspicious-Needs Monitoring
2924,26592,0,Yes,7,Yes,Wire,23668,41901,44825,No,Highly Suspicious
2094,11924,3,No,2,No,Online,9830,30735,32829,No,Suspicious-Needs Monitoring
3590,32208,19,No,1,Yes,POS,28618,34092,37682,No,No Suspicious
9410,24614,1,No,1,Yes,Wire,15204,6242,15652,No,No Suspicious
8084,5488,4,Yes,1,No,POS,-2596,46307,54391,No,Highly Suspicious
1704,44882,2,No,5,No,POS,43178,6831,8535,Yes,Highly Suspicious
335,30923,8,No,7,No,Online,30588,33511,33846,No,Suspicious-Needs Monitoring
2008,40941,19,Yes,2,Yes,Wire,38933,12246,14254,No,No Suspicious
8667,34165,5,No,8,Yes,Wire,25498,36467,45134,No,No Suspicious
3630,6667,17,No,4,No,POS,3037,23302,26932,Yes,Highly Suspicious
5356,31213,5,No,3,Yes,POS,25857,8232,13588,No,No Suspicious
2735,9114,18,Yes,8,Yes,Online,6379,41526,44261,No,Suspicious-Needs Monitoring
8262,41321,11,No,2,No,ATM,33059,43765,52027,No,No Suspicious
9862,12761,10,Yes,3,No,ATM,2899,15972,25834,Yes,Highly Suspicious
2660,36116,1,Yes,3,No,POS,33456,39592,42252,No,Highly Suspicious
5515,38768,14,No,1,Yes,ATM,33253,15683,21198,No,No Suspicious
3491,30426,11,No,6,No,ATM,26935,28664,32155,No,Suspicious-Needs Monitoring
6051,22772,11,Yes,2,Yes,ATM,16721,41828,47879,No,No Suspicious
5568,43218,8,Yes,1,Yes,ATM,37650,38172,43740,No,No Suspicious
8107,8712,20,Yes,2,Yes,POS,605,23105,31212,No,No Suspicious
9164,6367,23,Yes,6,Yes,ATM,-2797,26700,35864,No,Highly Suspicious
9544,45957,1,Yes,4,Yes,ATM,36413,16017,25561,No,Suspicious-Needs Monitoring
6513,46781,21,Yes,6,Yes,Online,40268,41613,48126,No,Suspicious-Needs Monitoring
7041,31200,2,No,9,Yes,POS,24159,25594,32635,Yes,Highly Suspicious
9606,8726,11,No,8,Yes,Wire,-880,16384,25990,No,No Suspicious
4920,28616,15,No,1,Yes,Wire,23696,35348,40268,No,No Suspicious
2998,32723,20,No,8,Yes,Online,29725,21448,24446,No,No Suspicious
7646,42574,23,Yes,9,Yes,Online,34928,14491,22137,No,Highly Suspicious
177,39958,0,No,6,No,POS,39781,18112,18289,No,Highly Suspicious
7677,14108,20,No,5,No,Wire,6431,36021,43698,No,No Suspicious
4327,17178,2,No,6,Yes,ATM,12851,49553,53880,No,Suspicious-Needs Monitoring
700,40643,19,No,6,No,Online,39943,5968,6668,No,Suspicious-Needs Monitoring
1165,36324,1,No,9,Yes,Wire,35159,5368,6533,No,Suspicious-Needs Monitoring
2236,43360,8,No,4,Yes,POS,41124,13424,15660,No,No Suspicious
9610,22824,18,Yes,2,No,ATM,13214,40010,49620,No,Suspicious-Needs Monitoring
7043,13927,14,No,9,Yes,POS,6884,40851,47894,No,No Suspicious
7904,33144,17,No,2,No,Online,25240,30496,38400,Yes,Highly Suspicious
6665,36010,10,No,9,Yes,Wire,29345,35936,42601,No,No Suspicious
6084,27443,22,No,2,No,Wire,21359,18322,24406,No,No Suspicious
5242,19437,15,Yes,8,Yes,Wire,14195,6469,11711,No,Suspicious-Needs Monitoring
4770,49298,21,No,9,Yes,Wire,44528,42493,47263,No,No Suspicious
2290,44778,16,No,9,Yes,ATM,42488,9259,11549,Yes,Highly Suspicious
9284,16207,4,No,9,No,ATM,6923,41390,50674,No,Highly Suspicious
2812,30537,11,No,2,Yes,POS,27725,15292,18104,No,No Suspicious
2292,40757,10,Yes,4,No,ATM,38465,31841,34133,No,Suspicious-Needs Monitoring
1348,17040,14,No,7,Yes,Online,15692,33365,34713,No,No Suspicious
4133,46986,2,No,2,Yes,Online,42853,22207,26340,Yes,Highly Suspicious
2097,27612,0,No,1,Yes,Wire,25515,41199,43296,No,No Suspicious
3787,33441,19,No,3,Yes,Online,29654,27912,31699,Yes,Highly Suspicious
4118,11471,15,No,4,No,POS,7353,41919,46037,No,No Suspicious
2070,40631,1,No,8,Yes,ATM,38561,41981,44051,No,Suspicious-Needs Monitoring
8489,48461,1,Yes,6,Yes,ATM,39972,20235,28724,No,Highly Suspicious
5865,31523,2,No,2,Yes,ATM,25658,46757,52622,No,No Suspicious
1302,36348,7,No,9,Yes,Online,35046,38547,39849,No,No Suspicious
8235,6177,23,No,2,No,ATM,-2058,48810,57045,No,Suspicious-Needs Monitoring
5667,9760,14,No,5,Yes,Wire,4093,24276,29943,No,No Suspicious
7767,37779,6,No,4,Yes,Wire,30012,36923,44690,Yes,Highly Suspicious
5842,26636,5,Yes,7,No,Wire,20794,10534,16376,No,Highly Suspicious
5888,21353,8,No,8,No,Online,15465,31469,37357,No,Suspicious-Needs Monitoring
5508,16556,19,Yes,5,Yes,ATM,11048,41074,46582,No,No Suspicious
8769,32598,0,No,5,Yes,Online,23829,40670,49439,No,No Suspicious
9546,16563,7,Yes,2,Yes,ATM,7017,37563,47109,No,No Suspicious
1022,48790,22,No,8,Yes,POS,47768,41486,42508,No,No Suspicious
519,13234,22,No,2,No,POS,12715,5021,5540,No,No Suspicious
2304,30519,2,Yes,6,Yes,Online,28215,39268,41572,No,Highly Suspicious
1220,31966,3,No,8,Yes,Wire,30746,46802,48022,No,Suspicious-Needs Monitoring
1050,21173,14,No,6,Yes,Online,20123,20799,21849,No,No Suspicious
2436,31987,5,Yes,4,Yes,Wire,29551,31336,33772,No,No Suspicious
5473,18178,14,No,4,Yes,ATM,12705,8641,14114,Yes,Highly Suspicious
2343,44338,20,No,6,Yes,Wire,41995,26596,28939,No,No Suspicious
2745,29596,2,No,4,Yes,Wire,26851,37959,40704,No,No Suspicious
4712,38174,20,Yes,8,Yes,ATM,33462,18306,23018,No,Suspicious-Needs Monitoring
1965,46974,20,Yes,9,Yes,POS,45009,13587,15552,No,Suspicious-Needs Monitoring
6128,9431,13,Yes,1,Yes,ATM,3303,36359,42487,No,No Suspicious
7426,32764,19,Yes,4,Yes,Online,25338,26498,33924,No,No Suspicious
6471,26627,13,Yes,4,Yes,Online,20156,9662,16133,No,No Suspicious
6459,44310,3,No,2,Yes,Online,37851,42094,48553,No,No Suspicious
7963,13906,11,No,6,Yes,Online,5943,46833,54796,No,No Suspicious
3328,41914,16,No,3,Yes,Online,38586,32197,35525,No,No Suspicious
3819,49814,6,No,7,Yes,POS,45995,25719,29538,No,No Suspicious
2471,18076,8,Yes,5,No,POS,15605,29665,32136,No,Suspicious-Needs Monitoring
2991,42650,2,Yes,4,No,Wire,39659,48239,51230,No,Highly Suspicious
3856,11012,12,No,5,No,Online,7156,30032,33888,No,No Suspicious
4325,12151,14,Yes,8,Yes,ATM,7826,17641,21966,Yes,Highly Suspicious
194,33211,17,No,3,No,Online,33017,46964,47158,No,No Suspicious
2774,32117,18,No,7,Yes,POS,29343,35028,37802,No,No Suspicious
6998,41378,0,No,6,Yes,Online,34380,20651,27649,No,Suspicious-Needs Monitoring
893,47652,5,No,1,Yes,POS,46759,13536,14429,No,No Suspicious
2216,11894,22,No,7,No,Wire,9678,11273,13489,No,Suspicious-Needs Monitoring
5879,18467,1,No,7,Yes,Wire,12588,11284,17163,No,Suspicious-Needs Monitoring
6266,36010,23,No,1,Yes,Wire,29744,30692,36958,No,No Suspicious
914,47641,13,No,9,No,POS,46727,13817,14731,No,Suspicious-Needs Monitoring
445,17289,5,No,6,No,Online,16844,33955,34400,No,Suspicious-Needs Monitoring
8654,49976,13,No,2,Yes,Online,41322,31555,40209,No,No Suspicious
2543,48596,3,No,5,Yes,ATM,46053,25378,27921,No,No Suspicious
7883,28171,20,No,4,Yes,POS,20288,46182,54065,No,No Suspicious
1084,39905,7,No,7,No,ATM,38821,22127,23211,No,Suspicious-Needs Monitoring
7890,25829,2,No,8,Yes,Wire,17939,22952,30842,No,Suspicious-Needs Monitoring
9931,39054,18,Yes,1,Yes,Online,29123,16539,26470,No,No Suspicious
927,49139,13,No,5,No,POS,48212,19692,20619,No,No Suspicious
3631,34734,19,No,3,Yes,ATM,31103,23120,26751,No,No Suspicious
7247,12052,16,No,1,Yes,ATM,4805,18334,25581,No,No Suspicious
4551,8654,7,Yes,3,Yes,ATM,4103,33615,38166,No,No Suspicious
3976,28486,23,No,6,Yes,Online,24510,12903,16879,No,Suspicious-Needs Monitoring
6059,23743,13,No,7,Yes,Online,17684,33527,39586,Yes,Highly Suspicious
226,29489,5,No,8,Yes,Online,29263,20629,20855,No,No Suspicious
